0 0 0 1 1 1 1 2
0 0 3 1 1 3 1 2
0 1 1 1 1 1 1 2
3 1 1 1 1 1 1 2
0 0 3 0 0 0 0 0

pr, 3, 5
sv, 2, 1
sv, 2, 2