1 1 3 1 1 2 1 1
1 1 1 1 1 2 1 1
1 1 1 1 1 1 1 1
0 0 0 1 1 1 1 1
0 0 0 0 1 1 1 1
0 0 0 0 1 1 1 1

pd, 0, 6
sv, 3, 5
sv, 3, 6
