0 1 1 1 1 1
1 1 0 0 0 1
1 0 0 2 0 1
1 0 2 0 0 1
1 0 0 0 1 1
1 1 1 1 1 0

pd, 4, 0
sh, 0, 2