1 1 1 1 1 1 1 1 0
1 1 1 1 1 1 1 1 0
1 1 1 1 3 1 3 3 3
1 1 1 1 1 1 1 2 3
1 1 1 1 1 1 1 2 3

pr, 1, 2
sv, 3, 1
sv, 3, 2