0 1 1 1 1 1 1
0 2 2 0 0 0 1
0 2 2 0 2 2 1
1 1 1 1 2 2 1
0 2 2 1 1 1 1
0 2 2 1 0 0 0
0 1 1 1 0 0 0

pr, 3, 0
sh, 0, 1
sv, 2, 6
sh, 6, 1
