0 3 3 1 1 1 1 3 3 3
3 1 2 1 1 1 1 2 1 3
3 1 2 1 1 1 1 2 1 3
3 3 3 1 1 1 1 3 3 3
0 1 1 1 1 1 1 1 1 0
0 1 1 1 1 1 1 1 1 0

pd, 3, 5
sh, 2, 4
sh, 1, 4
