0 0 0 1 1 1 1 1 1 1
0 0 0 1 0 1 0 0 0 1
0 2 2 2 2 0 0 0 0 1
0 2 2 2 2 1 1 1 1 1
0 0 0 0 0 0 0 0 0 0
1 1 2 2 0 0 0 0 0 0

pu, 3, 9
sv, 2, 7
sv, 2, 6
sv, 2, 5
