0 0 0 0 0 0 0 3 3 0
0 0 0 0 0 0 3 1 2 2
0 0 0 0 0 3 1 1 2 2
0 0 0 0 3 1 1 1 1 0
3 1 1 1 1 1 0 0 2 0
3 1 1 1 1 0 0 0 2 2
3 1 1 0 0 0 0 0 0 0
0 3 1 1 0 0 0 0 0 0
0 0 3 1 1 0 0 0 0 0
0 0 0 3 1 1 1 1 1 0
0 0 1 1 1 1 0 0 1 0
0 0 1 1 1 1 0 3 1 0
0 0 1 1 1 1 0 0 1 0
0 0 0 0 0 1 1 1 1 0

pr, 10, 2
sv, 10, 5
sh, 12, 3